1111111111111
100000P000001
1011111111101
1CCCCCCCCCCC1
100000E000001
1111111111111