11111111111
100C0CCCCC1
110I0000001
1C000P0IEI1
11111111111