11111111111
100C0CCCCC1
1PCCCCC0001
1C000000E01
11111111111