11111111111
1CCCCCCCCC1
1CCCCCCCCC1
1CPECCCCCC1
11111111111