1111111111
1000000011
1000000001
1CCCCC0001
10000P0001
10000E0001
1111111111