11111111111
100C0CCCCC1
10000CC0001
1C000P00E01
11111111111