111111111111111
100000P00000001
111111111111001
1CCCCCCCCCC1001
110000E00000001
11111111111111111