11111111111
10000CC1C11
111CCCC1111
1PE00000001
11111111111