11111111111
10000CCCC01
111CCCCCCC1
1PE00000001
11111111111