1111111111111
10000000001E1
100000000010111
1P000000000C1
1111111111111