1111111111111
10000000001E1
1000000000101
1P000000000C1
1111111111111