1111111111111
100100C000FC1
1C00011111001
1P0011E000001
1111111111111
