1111111111111
10000000I0IC1
10I000I0000C1
1PEI000010001
1111111111111