1111111111111
10000000N0NC1
10N000N00 0C1
1PEN000010001
1111111111111